treatment related finding	TREATMENT_RELATED_EFFECT_DETECTED	MISC	30.0
treatment related findings	TREATMENT_RELATED_EFFECT_DETECTED	MISC	30.0
treatment related effect	TREATMENT_RELATED_EFFECT_DETECTED	MISC	30.0
treatment-related effect	TREATMENT_RELATED_EFFECT_DETECTED	MISC	30.0
treatment-related effects	TREATMENT_RELATED_EFFECT_DETECTED	MISC	30.0
treatment related effects	TREATMENT_RELATED_EFFECT_DETECTED	MISC	30.0
treatment-related-finding	TREATMENT_RELATED_EFFECT_DETECTED	MISC	30.0
treatment-related-findings	TREATMENT_RELATED_EFFECT_DETECTED	MISC	30.0
related effects	TREATMENT_RELATED_EFFECT_DETECTED	MISC	30.0
related effect	TREATMENT_RELATED_EFFECT_DETECTED	MISC	30.0
adverse effects	TREATMENT_RELATED_EFFECT_DETECTED	MISC	30.0
dose related	TREATMENT_RELATED_EFFECT_DETECTED	MISC	30.0
dose-related	TREATMENT_RELATED_EFFECT_DETECTED	MISC	30.0
related to dose	TREATMENT_RELATED_EFFECT_DETECTED	MISC	30.0
abnormal	TREATMENT_RELATED_EFFECT_DETECTED	MISC	10.0
compound-related effect	TREATMENT_RELATED_EFFECT_DETECTED	MISC	30.0
compound-related effects	TREATMENT_RELATED_EFFECT_DETECTED	MISC	30.0
compound- related	TREATMENT_RELATED_EFFECT_DETECTED	MISC	30.0
compound-related	TREATMENT_RELATED_EFFECT_DETECTED	MISC	30.0
compound related	TREATMENT_RELATED_EFFECT_DETECTED	MISC	30.0
compound related findings	TREATMENT_RELATED_EFFECT_DETECTED	MISC	30.0
compound related finding	TREATMENT_RELATED_EFFECT_DETECTED	MISC	30.0
compound-related findings	TREATMENT_RELATED_EFFECT_DETECTED	MISC	30.0
compound-related finding	TREATMENT_RELATED_EFFECT_DETECTED	MISC	30.0
substance-related	TREATMENT_RELATED_EFFECT_DETECTED	MISC	30.0
substance- related	TREATMENT_RELATED_EFFECT_DETECTED	MISC	30.0
substance related	TREATMENT_RELATED_EFFECT_DETECTED	MISC	30.0
compound effect	TREATMENT_RELATED_EFFECT_DETECTED	MISC	30.0
compound effects	TREATMENT_RELATED_EFFECT_DETECTED	MISC	30.0
effect of the compound	TREATMENT_RELATED_EFFECT_DETECTED	MISC	30.0
effects of the compound	TREATMENT_RELATED_EFFECT_DETECTED	MISC	30.0
effects of the compounds	TREATMENT_RELATED_EFFECT_DETECTED	MISC	30.0
effect of the compounds	TREATMENT_RELATED_EFFECT_DETECTED	MISC	30.0
finding	TREATMENT_RELATED_EFFECT_DETECTED	MISC	10.0
findings	TREATMENT_RELATED_EFFECT_DETECTED	MISC	10.0
related effect	TREATMENT_RELATED_EFFECT_DETECTED	MISC	30.0
related effect found	TREATMENT_RELATED_EFFECT_DETECTED	MISC	30.0
treatment-related	TREATMENT_RELATED_EFFECT_DETECTED	MISC	30.0
treatment related	TREATMENT_RELATED_EFFECT_DETECTED	MISC	30.0
further finding	TREATMENT_RELATED_EFFECT_DETECTED	MISC	30.0
related findings	TREATMENT_RELATED_EFFECT_DETECTED	MISC	30.0
related finding	TREATMENT_RELATED_EFFECT_DETECTED	MISC	30.0
effect of treatment	TREATMENT_RELATED_EFFECT_DETECTED	MISC	30.0
regarded as adverse effect	TREATMENT_RELATED_EFFECT_DETECTED	MISC	30.0
regarded as adverse effects	TREATMENT_RELATED_EFFECT_DETECTED	MISC	30.0
were regarded or suspected to be treatment-related	TREATMENT_RELATED_EFFECT_DETECTED	MISC	30.0
were regarded to be treatment-related	TREATMENT_RELATED_EFFECT_DETECTED	MISC	30.0
were considered to be treatment-related	TREATMENT_RELATED_EFFECT_DETECTED	MISC	30.0
suspected to be treatment-related	TREATMENT_RELATED_EFFECT_DETECTED	MISC	30.0
attributable to treatment	TREATMENT_RELATED_EFFECT_DETECTED	MISC	30.0
effect of treatment	TREATMENT_RELATED_EFFECT_DETECTED	MISC	30.0
administration of the compound	TREATMENT_RELATED_EFFECT_DETECTED	MISC	30.0
no compound-related effect	NO_TREATMENT_RELATED_EFFECT_DETECTED	MISC	30.0
not treatment-related	NO_TREATMENT_RELATED_EFFECT_DETECTED	MISC	30.0
no compound-related effect	NO_TREATMENT_RELATED_EFFECT_DETECTED	MISC	30.0
not compound-related	NO_TREATMENT_RELATED_EFFECT_DETECTED	MISC	30.0
rather than a treatment-related effect	NO_TREATMENT_RELATED_EFFECT_DETECTED	MISC	30.0
not considered as a compound-related effect	NO_TREATMENT_RELATED_EFFECT_DETECTED	MISC	30.0
no evidence for treatment-related effects	NO_TREATMENT_RELATED_EFFECT_DETECTED	MISC	30.0
no evidence for treatment-related effect	NO_TREATMENT_RELATED_EFFECT_DETECTED	MISC	30.0
treatment-related effect is not assumed	NO_TREATMENT_RELATED_EFFECT_DETECTED	MISC	30.0
no related effect	NO_TREATMENT_RELATED_EFFECT_DETECTED	MISC	30.0
no related effect found	NO_TREATMENT_RELATED_EFFECT_DETECTED	MISC	30.0
no treatment-related	NO_TREATMENT_RELATED_EFFECT_DETECTED	MISC	30.0
no treatment related	NO_TREATMENT_RELATED_EFFECT_DETECTED	MISC	30.0
no further finding	NO_TREATMENT_RELATED_EFFECT_DETECTED	MISC	30.0
no related findings	NO_TREATMENT_RELATED_EFFECT_DETECTED	MISC	30.0
no related finding	NO_TREATMENT_RELATED_EFFECT_DETECTED	MISC	30.0
no relevant compound-related effect	NO_TREATMENT_RELATED_EFFECT_DETECTED	MISC	30.0
no relevant compound-related effects	NO_TREATMENT_RELATED_EFFECT_DETECTED	MISC	30.0
not suspicious for a treatment-related effect	NO_TREATMENT_RELATED_EFFECT_DETECTED	MISC	30.0
unrelated to the treatment	NO_TREATMENT_RELATED_EFFECT_DETECTED	MISC	30.0
not to be treatment-related	NO_TREATMENT_RELATED_EFFECT_DETECTED	MISC	30.0
not regarded to be treatment-related	NO_TREATMENT_RELATED_EFFECT_DETECTED	MISC	30.0
not regarded as being treatment-related	NO_TREATMENT_RELATED_EFFECT_DETECTED	MISC	30.0
doubtful toxicological significance	NO_TREATMENT_RELATED_EFFECT_DETECTED	MISC	30.0
masculine|macho|machos	MALE_SEX	MISC	10.0
feminine|feminines	FEMALE_SEX	MISC	10.0
g|mg|kg|lb|ml|dg|ng|mcg|mcl|mg/kg|mg/kg/day|mg/kg/dose|mg/kg/d|g/day|mcmol/g|mg/m|pg/kg|pmol/kg|Î¼mol Gd/kg bw	DOSE_UNIT	MISC	25.0
never|neither|nobody|no|none|nor|nothing|nowhere|not|rather|without	NEGATION_KEYWORD	MISC	25.0 