increase	MANUAL_CODE=INCREASE	MANUAL_SEND_CODE=I
increased	MANUAL_E=INCREASE	MANUAL_SEND_CODE=I
increasing	MANUAL_CODE=INCREASE	MANUAL_SEND_CODE=I
increment	MANUAL_CODE=INCREASE	MANUAL_SEND_CODE=I
increases	MANUAL_CODE=INCREASE	MANUAL_SEND_CODE=I
higher	MANUAL_CODE=INCREASE	MANUAL_SEND_CODE=I
high	MANUAL_CODE=INCREASE	MANUAL_SEND_CODE=I
decrease	MANUAL_CODE=DECREASE	MANUAL_SEND_CODE=D
decreases	MANUAL_CODE=DECREASE	MANUAL_SEND_CODE=D
decreased	MANUAL_CODE=DECREASE	MANUAL_SEND_CODE=D
decreasing	MANUAL_CODE=DECREASE	MANUAL_SEND_CODE=D
reduction	MANUAL_CODE=DECREASE	MANUAL_SEND_CODE=D
minimal	MANUAL_CODE=DECREASE	MANUAL_SEND_CODE=D
reductions	MANUAL_CODE=DECREASE	MANUAL_SEND_CODE=D
impaired	MANUAL_CODE=DECREASE	MANUAL_SEND_CODE=D
reduced	MANUAL_CODE=DECREASE	MANUAL_SEND_CODE=D
loss	MANUAL_CODE=DECREASE	MANUAL_SEND_CODE=D
low	MANUAL_CODE=DECREASE	MANUAL_SEND_CODE=D
lower	MANUAL_CODE=DECREASE	MANUAL_SEND_CODE=D
changed	MANUAL_CODE=CHANGE	MANUAL_SEND_CODE=C
change	MANUAL_CODE=CHANGE	MANUAL_SEND_CODE=C
changes	MANUAL_CODE=CHANGE	MANUAL_SEND_CODE=C
modification	MANUAL_CODE=CHANGE	MANUAL_SEND_CODE=C
modifications	MANUAL_CODE=CHANGE	MANUAL_SEND_CODE=C
transitory	MANUAL_CODE=TRANSITORY	MANUAL_SEND_CODE=T
slight prolongation	MANUAL_CODE=INCREASE	MANUAL_SEND_CODE=I