increase	CODE=INCREASE
increased	CODE=INCREASE
increasing	CODE=INCREASE
increment	CODE=INCREASE
decrease	CODE=DECREASE
decreased	CODE=DECREASE
decreasing	CODE=DECREASE
reduction	CODE=DECREASE
loss	CODE=DECREASE
low	CODE=DECREASE
transitory	CODE=TRANSITORY
present	CODE=JUSTPRESENT
observable	CODE=JUSTPRESENT
observed	CODE=JUSTPRESENT
showed	CODE=JUSTPRESENT
show	CODE=JUSTPRESENT
noticed	CODE=JUSTPRESENT
detected	CODE=JUSTPRESENT
detect	CODE=JUSTPRESENT
recognized	CODE=JUSTPRESENT
perceived	CODE=JUSTPRESENT
identified	CODE=JUSTPRESENT